TTTWTWTTTT
TTTWTWTWWT
TWWWTWTWWT
TTTTTWTTTT
WWWWTWWWWT
TWTWTTTTWT
TWTWTWWTWT
TTTTTWWTWT
TWWWTTTTWT
TWWWWWWTWT
TWTWTWTTTT